R         1920    1080    
NO        ./path_to_the_north_texture
SO ./path_to_the_south_texture
WE ./path_to_the_west_texture
EA ./path_to_the_east_texture
S ./path_to_the_sprite_texture
F 229,111,200
C 244,020,50


1111111
1000011
1NSW011
1111001
1111101